20 20
074 101 101 101 101 101 101 101 101 101 101 101 101 101 101 101 101 101 101 075
090 051 051 051 051 051 051 051 051 051 051 051 051 051 051 051 051 051 051 088
090 051 051 051 051 051 051 051 051 051 051 051 051 051 051 051 051 051 051 088
090 051 051 051 051 051 051 051 051 051 051 051 051 051 051 051 051 051 051 088
090 051 051 051 051 051 051 051 051 051 051 051 051 051 051 051 051 051 051 088
090 051 051 051 051 051 051 051 051 051 051 051 051 051 051 051 051 051 051 088
090 051 051 051 051 051 051 051 051 051 051 051 051 051 051 051 051 051 051 088
090 051 051 051 051 051 051 051 051 051 051 051 051 051 051 051 051 051 051 088
090 051 051 051 051 051 051 051 051 051 051 051 051 051 051 051 051 051 051 088
090 051 051 051 051 051 051 051 051 018 018 051 051 051 051 051 051 051 051 088
090 051 051 051 051 051 051 051 051 030 030 051 051 051 051 051 051 051 051 088
090 051 051 051 051 051 051 051 051 051 051 051 051 051 051 051 051 051 051 088
090 051 051 051 051 051 051 051 051 051 051 051 051 051 051 051 051 051 051 088
090 051 051 051 051 051 051 051 051 051 051 051 051 051 051 051 051 051 051 088
090 051 051 051 051 051 051 051 051 051 051 051 051 051 051 051 051 051 051 088
090 051 051 051 051 051 051 051 051 051 051 051 051 051 051 051 051 051 051 088
090 051 051 051 051 051 051 051 051 051 051 051 051 051 051 051 051 051 051 088
090 051 051 051 051 051 051 051 051 051 051 051 051 051 051 051 051 051 051 088
090 051 051 051 051 051 051 051 051 051 051 051 051 051 051 051 051 051 051 088
086 077 077 077 077 077 077 077 077 077 077 077 077 077 077 077 077 077 077 087